As you walk up to the old, abandoned building on Elk Street, a chill runs down your spine.  You have been informed that it used to be a popular arcade that faded out with the times.  It hasn't been touched in many, many years.  It seems pretty dark in the building, so you should probably find the switch for the electric box in order to turn the power on.  Maybe you will find something interesting to write about.

Retro Arcade
A Retro Mystery. by Aaron Murai The story creation year is 2017
Release 1 / Serial number 170301 / Inform 7 build 6M62 (I6/v6.33 lib 6/12N) SD

Outside
Outside the abandoned building, you don't know what to expect.  As long as you have your phone, pen and notepad, you'll be just fine.  Make sure you have some sort of light...

>i
You are carrying:
  Pen
  Notepad
  Flashlight

>eat pencil
That's plainly inedible.

* * *

>i
You are carrying:
  Pen
  Notepad
  Flashlight

>use flashlight
That's not a verb I recognise.

>turn on flashlight
[Your score has just gone up by one point.]

>north
Main Arcade Room
 This large room includes the air hockey table and food counter.  In the front, there are many arcade machines, coated with dust, dirt, and spider webs.  The room lights up after being in the dark for so long.  You can picture kids and adults alike spending countless hours engaged in killing aliens, or stacking blocks.  The door to the back alley is behind the hockey table and food counter.  You should probably find the power switch so you don't have to hold your flashlight the whole time.  While old and dusty, it seems as if people have broken in before to walk around and maybe even steal the arcade machines.  The bathroom is to the west, and a party room to the east, according to your boss, and the employees room is to the west of the hockey table. 

You can see Pager, Pac-Man, Space Invaders, Donkey Kong, and Tetris here.

>turn on phone
It isn't something you can switch.

>x pager
The brightly lit green screen gives off some light.  Strange to find a working pager in an abonded arcade.  Nevertheless, it seems useful.  Might as well take it.

>take pager
I don't suppose Pager would care for that.

>i
You are carrying:
  Pen
  Notepad
  Phone
  Flashlight (providing light)

>x pac-man
You can't see any such thing.

>x Pac-Man
You can't see any such thing.

>x space invaders
You can't see any such thing.

>x donkey kong
You can't see any such thing.

>x tetris
You can't see any such thing.

>west
Bathroom
For an abandonded building, the bathroom doesn't smell bad and it isn't very dirty.  Strange.

>x bathroom
You can't see any such thing.

>east
Main Arcade Room
Lots of dusty arcade machines around.  The whole room just gives off a classic, 80s vibe.  Oh boy, what simpler times.

You can see Pager, Pac-Man, Space Invaders, Donkey Kong, and Tetris here.

>east
Party Room
This was probably used to hold special party rooms.  There are portable tables set up and a couple boxes in the corner, but other than that, it's a plain room.  Wow, a birthday party in an arcade.  Must've been a 12 year old's dream.

>x boxes
A bunch of old, dusty cardboard boxes stacked in the corner.  They seem to make up the shape of a pyramid.  The boxes were placed with such effort and precision, it seems like it would be hiding something.

>move boxes
It is fixed in place.

>push boxes
It is fixed in place.

>open boxes
It isn't something you can open.

>x portable tables
You can't see any such thing.

>x tables
You can't see any such thing.

>west
Main Arcade Room
Lots of dusty arcade machines around.  The whole room just gives off a classic, 80s vibe.  Oh boy, what simpler times.

You can see Pager, Pac-Man, Space Invaders, Donkey Kong, and Tetris here.

>northwest
Hockey Table Room
This part of the Main Arcade Room must've been used for hockey table games.  The table is worn down and there are white marks, presumably from the paddles, on the sides.  It must've been very popular.

You can see Air Hockey Table (closed) here.

>open air hockey table
You can't see any such thing.

>ne
Back Alley
A dark and dank back alley.  It seems really dirty and rats sneak in and out past garbage cans and cardboard boxes.

>x garbage can
You can't see any such thing.

>x cardboard boxes
You can't see any such thing.

>south west
I only understood you as far as wanting to (go) south.

>sw
Hockey Table Room
This part of the Main Arcade Room must've been used for hockey table games.  The table is worn down and there are white marks, presumably from the paddles, on the sides.  It must've been very popular.

You can see Air Hockey Table (closed) here.

>ne
Back Alley
A dark and dank back alley.  It seems really dirty and rats sneak in and out past garbage cans and cardboard boxes.

>se
Food Counter
This part of the Main Arcade Room was probably used to serve all the customers food like pizza, candy, and sodas.  The counter is painted bright red, and there is a bright blue neon sign on the wall saying, "Food and Drink", and a pizza poster.

>x poster
You can't see any such thing.

>x pizza poster
You can't see any such thing.

>sw
Main Arcade Room
Lots of dusty arcade machines around.  The whole room just gives off a classic, 80s vibe.  Oh boy, what simpler times.

You can see Pager, Pac-Man, Space Invaders, Donkey Kong, and Tetris here.

>i
You are carrying:
  Pen
  Notepad
  Phone
  Flashlight (providing light)

>use phone
That's not a verb I recognise.

>take out phone
I only understood you as far as wanting to take outside.

>x phone
An off brand phone that was assigned to you for stories.  It has standard call and text options, but no app store.  It also comes with a flashlight and bluetooth.

>x notepad
Your trusty notepad that you have used over the past year.  It's riddled with sketches, doodles, and useless notes from stories that didn't make the website.  But, things will change with this story!

>x pen
A new, ball point pen used for writing down notes.  Don't lose it!

>drop pen
Dropped.

>ne
Food Counter
This part of the Main Arcade Room was probably used to serve all the customers food like pizza, candy, and sodas.  The counter is painted bright red, and there is a bright blue neon sign on the wall saying, "Food and Drink", and a pizza poster.

I beg your pardon?

>i
You are carrying:
  Notepad
  Phone
  Flashlight (providing light)

>w
You can't go that way.

>sw
Main Arcade Room
Lots of dusty arcade machines around.  The whole room just gives off a classic, 80s vibe.  Oh boy, what simpler times.

You can see Pen, Pager, Pac-Man, Space Invaders, Donkey Kong, and Tetris here.

>take pen
Taken.

>draw on notepad
That's not a verb I recognise.

>open pac-man
You can't see any such thing.

>open machine
You can't see any such thing.

>x machine1
A classic Pac-Man machine.  Hey, I used to play this at my local arcade!  It's covered in dust from the top to the bottom.  Hey, what's this next to the controls?

>x controls
It's used to control Pac-Man.  There is a dusty quarter next to it.

>take quarter
[Your score has just gone up by one point.]

>x machine2
Another classic arcade game.  In fact, I have a Space Invader's alien sticker on my laptop.  The control pad seems to be faded and dusty.  Nothing special seems to stick out.

>x control pad
You can't see any such thing.

>x machine 3
You can't see any such thing.

>x machine3
Donkey Kong?!  This is where Mario first appeared.  Wow, the colors really seem to pop off the machine.  Impressive for a game released in 1981.  Nothing special seems to stick out.

>x machine 4
You can't see any such thing.

>x machine4
One of the most recognizable games.  The colors have faded from the blocks on the side of the machine.  It's also covered in dust and spider webs.

>w
Bathroom
For an abandonded building, the bathroom doesn't smell bad and it isn't very dirty.  Strange.

>x toilet
You can't see any such thing.

>take puck
Taken.

>take all
There are none at all available!

>i
You are carrying:
  Air Hockey Puck
  Quarter
  Pen
  Notepad
  Phone
  Flashlight (providing light)

>e
Main Arcade Room
Lots of dusty arcade machines around.  The whole room just gives off a classic, 80s vibe.  Oh boy, what simpler times.

You can see Pager, Pac-Man, Space Invaders, Donkey Kong, and Tetris here.

>turn on light
You can't see any such thing.

>nw
Hockey Table Room
This part of the Main Arcade Room must've been used for hockey table games.  The table is worn down and there are white marks, presumably from the paddles, on the sides.  It must've been very popular.

You can see Air Hockey Table (closed) here.

>sw
You can't go that way.

>se
Main Arcade Room
Lots of dusty arcade machines around.  The whole room just gives off a classic, 80s vibe.  Oh boy, what simpler times.

You can see Pager, Pac-Man, Space Invaders, Donkey Kong, and Tetris here.

>e
Party Room
This was probably used to hold special party rooms.  There are portable tables set up and a couple boxes in the corner, but other than that, it's a plain room.  Wow, a birthday party in an arcade.  Must've been a 12 year old's dream.

>look behind boxes
You found the two missing paddles for the air hockey table.  Go put it on the table.

>take paddles
You already have that.

>w
Main Arcade Room
Lots of dusty arcade machines around.  The whole room just gives off a classic, 80s vibe.  Oh boy, what simpler times.

You can see Pager, Pac-Man, Space Invaders, Donkey Kong, and Tetris here.

>nw
Hockey Table Room
This part of the Main Arcade Room must've been used for hockey table games.  The table is worn down and there are white marks, presumably from the paddles, on the sides.  It must've been very popular.

You can see Air Hockey Table (closed) here.

>put paddles on air hockey table
You can't see any such thing.

* * *

>n
Darkness
It's super dark in here!  Well duh, if it's an abandoned building, there is no power.  Maybe you have a source of light already...

>e
Darkness
It's super dark in here!  Well duh, if it's an abandoned building, there is no power.  Maybe you have a source of light already...

>w
Darkness
It's super dark in here!  Well duh, if it's an abandoned building, there is no power.  Maybe you have a source of light already...

>turn flashlight on
Main Arcade Room
Lots of dusty arcade machines around.  The whole room just gives off a classic, 80s vibe.  Oh boy, what simpler times.

You can see Pager, Pac-Man, Space Invaders, Donkey Kong, and Tetris here.

[Your score has just gone up by one point.]

* * *

>e
Darkness
It's super dark in here!  Well duh, if it's an abandoned building, there is no power.  Maybe you have a source of light already...

>x boxes
A bunch of old, dusty cardboard boxes stacked in the corner.  They seem to make up the shape of a pyramid.  The boxes were placed with such effort and precision, it seems like it would be hiding something.

>look behind boxes
You found the two missing paddles for the air hockey table.  Go put it on the table.

>x boxes
A bunch of old, dusty cardboard boxes stacked in the corner.  They seem to make up the shape of a pyramid.  The boxes were placed with such effort and precision, it seems like it would be hiding something.

>u
You can't go that way.

>i
You are carrying:
  Hockey Paddles
  Pen
  Notepad
  Phone
  Flashlight

* * *

>n
Darkness
It's super dark in here!  Well duh, if it's an abandoned building, there is no power.  Maybe you have a source of light already...

>i
You are carrying:
  Pen
  Notepad
  Phone
  Flashlight

>eat flashlight
That's plainly inedible.

>ne
Food Counter
This part of the Main Arcade Room was probably used to serve all the customers food like pizza, candy, and sodas.  The counter is painted bright red, and there is a bright blue neon sign on the wall saying, "Food and Drink", and a pizza poster.

>sw
Main Arcade Room
You can see Pager, Pac-Man, Space Invaders, Donkey Kong, and Tetris here.

>nw
Hockey Table Room
This part of the Main Arcade Room must've been used for hockey table games.  The table is worn down and there are white marks, presumably from the paddles, on the sides.  It must've been very popular.

You can see a Hockey Table (closed) here.

>x hockey table
A bright, neon green and blue air hockey table.  It looks like it's still in a playable condition.  If only you had the two paddles and a hockey puck, you could play it.  On the side, there is a sign that says "25 cents required".

* * *

>i
You are carrying:
  Pen
  Notepad
  Phone
  Flashlight

>use flashlight
That's not a verb I recognise.

>turn on flashlight
Main Arcade Room
 This large room includes the air hockey table and food counter.  In the front, there are many arcade machines, coated with dust, dirt, and spider webs.  The room lights up after being in the dark for so long.  You can picture kids and adults alike spending countless hours engaged in killing aliens, or stacking blocks.  The door to the back alley is behind the hockey table and food counter.  You should probably find the power switch so you don't have to hold your flashlight the whole time.  While old and dusty, it seems as if people have broken in before to walk around and maybe even steal the arcade machines.  The bathroom is to the west, and a party room to the east, according to your boss, and the employees room is to the west of the hockey table. 

You can see Pager, Pac-Man, Space Invaders, Donkey Kong, and Tetris here.

[Your score has just gone up by one point.]

>ne
Food Counter
This part of the Main Arcade Room was probably used to serve all the customers food like pizza, candy, and sodas.  The counter is painted bright red, and there is a bright blue neon sign on the wall saying, "Food and Drink", and a pizza poster.

>nw
Back Alley
A dark and dank back alley.  It seems really dirty and rats sneak in and out past garbage cans and cardboard boxes.

>se
Food Counter
This part of the Main Arcade Room was probably used to serve all the customers food like pizza, candy, and sodas.  The counter is painted bright red, and there is a bright blue neon sign on the wall saying, "Food and Drink", and a pizza poster.

>nw
Back Alley
A dark and dank back alley.  It seems really dirty and rats sneak in and out past garbage cans and cardboard boxes.

>sw
Hockey Table Room
This part of the Main Arcade Room must've been used for hockey table games.  The table is worn down and there are white marks, presumably from the paddles, on the sides.  It must've been very popular.

You can see Air Hockey Table (closed) here.

>se
Main Arcade Room
Lots of dusty arcade machines around.  The whole room just gives off a classic, 80s vibe.  Oh boy, what simpler times.

You can see Pager, Pac-Man, Space Invaders, Donkey Kong, and Tetris here.

>s
Outside
Outside the abonded building, you don't know what to expect.  As long as you have your phone, pen and notepad, you'll be just fine.  Make sure you have some sort of light...

>n
Main Arcade Room
Lots of dusty arcade machines around.  The whole room just gives off a classic, 80s vibe.  Oh boy, what simpler times.

You can see Pager, Pac-Man, Space Invaders, Donkey Kong, and Tetris here.

>e
Party Room
This was probably used to hold special party rooms.  There are portable tables set up and a couple boxes in the corner, but other than that, it's a plain room.  Wow, a birthday party in an arcade.  Must've been a 12 year old's dream.

>w
Main Arcade Room
Lots of dusty arcade machines around.  The whole room just gives off a classic, 80s vibe.  Oh boy, what simpler times.

You can see Pager, Pac-Man, Space Invaders, Donkey Kong, and Tetris here.

>w
Bathroom
For an abandonded building, the bathroom doesn't smell bad and it isn't very dirty.  Strange.

>e
Main Arcade Room
Lots of dusty arcade machines around.  The whole room just gives off a classic, 80s vibe.  Oh boy, what simpler times.

You can see Pager, Pac-Man, Space Invaders, Donkey Kong, and Tetris here.

>nw
Hockey Table Room
This part of the Main Arcade Room must've been used for hockey table games.  The table is worn down and there are white marks, presumably from the paddles, on the sides.  It must've been very popular.

You can see Air Hockey Table (closed) here.

>se
Main Arcade Room
Lots of dusty arcade machines around.  The whole room just gives off a classic, 80s vibe.  Oh boy, what simpler times.

You can see Pager, Pac-Man, Space Invaders, Donkey Kong, and Tetris here.

>ne
Food Counter
This part of the Main Arcade Room was probably used to serve all the customers food like pizza, candy, and sodas.  The counter is painted bright red, and there is a bright blue neon sign on the wall saying, "Food and Drink", and a pizza poster.

* * *

>n
Darkness
It's super dark in here!  Well duh, if it's an abandoned building, there is no power.  Maybe you have a source of light already...

>n
You can't go that way.

>s
Outside

>n
Main Arcade Room

>n
You can't go that way.

* * *

>s
Outside

>e
You can't go that way.

>w
You can't go that way.

>n
Main Arcade Room

>nw
Hockey Table

>se
Main Arcade Room

>s
Outside

* * *

>n
Main Arcade Room

>e
Party Room

>w
Main Arcade Room

>w
Bathroom

>kms
That's not a verb I recognise.

>x me
You are curious to see what lies in the abandoned building.  You brought your trusty camera, a pen and paper to jot down any thoughts you have.  As a young, and eager news reporter, this will be your first major scoop.  You can't mess this up!

* * *

>n
Darkness
It's super dark in here!  Well duh, if it's an abandoned building, there is no power.  Maybe you have a source of light already...

>ne
Darkness
It's super dark in here!  Well duh, if it's an abandoned building, there is no power.  Maybe you have a source of light already...

>sw
Darkness
It's super dark in here!  Well duh, if it's an abandoned building, there is no power.  Maybe you have a source of light already...

>e
Darkness
It's super dark in here!  Well duh, if it's an abandoned building, there is no power.  Maybe you have a source of light already...

* * *

>w
Darkness
It's super dark in here!  Well duh, if it's an abandoned building, there is no power.  Maybe you have a source of light already...

>s
Outside
Outside the abonded building, you don't know what to expect.  As long as you have your phone, pen and notepad, you'll be just fine.  Make sure you have some sort of light...

>n
Darkness
It's super dark in here!  Well duh, if it's an abandoned building, there is no power.  Maybe you have a source of light already...

* * *

>w
Darkness
It's super dark in here!  Well duh, if it's an abandoned building, there is no power.  Maybe you have a source of light already...

>w
Darkness
It's super dark in here!  Well duh, if it's an abandoned building, there is no power.  Maybe you have a source of light already...

>e
Darkness
It's super dark in here!  Well duh, if it's an abandoned building, there is no power.  Maybe you have a source of light already...

>ne
Darkness
It's super dark in here!  Well duh, if it's an abandoned building, there is no power.  Maybe you have a source of light already...

>nw
Darkness
It's super dark in here!  Well duh, if it's an abandoned building, there is no power.  Maybe you have a source of light already...

>turn on flashlight
Now you can see.

Back Alley
A dark and dank back alley.  It seems really dirty and rats sneak in and out past garbage cans and cardboard boxes.

[Your score has just gone up by one point.]

>s
You can't go that way.

>s
You can't go that way.

>se
Food Counter
This part of the Main Arcade Room was probably used to serve all the customers food like pizza, candy, and sodas.  The counter is painted bright red, and there is a bright blue neon sign on the wall saying, "Food and Drink", and a pizza poster.

>sw
Main Arcade Room
Lots of dusty arcade machines around.  The whole room just gives off a classic, 80s vibe.  Oh boy, what simpler times.

You can see Pager, Pac-Man, Space Invaders, Donkey Kong, and Tetris here.

>e
Party Room
This was probably used to hold special party rooms.  There are portable tables set up and a couple boxes in the corner, but other than that, it's a plain room.  Wow, a birthday party in an arcade.  Must've been a 12 year old's dream.

>take all
There are none at all available!

* * *

>n
Darkness
It's super dark in here!  Well duh, if it's an abandoned building, there is no power.  Maybe you have a source of light already...

>take all
There are none at all available!

>i
You are carrying:
  Pen
  Notepad
  Phone
  Flashlight

* * *

>n
Darkness
It's super dark in here!  Well duh, if it's an abandoned building, there is no power.  Maybe you have a source of light already...

>take pager
Looks like it will help you along the way.  Keep it if you need hints.

[Your score has just gone up by one point.]

>drop pager
Dropped.

>take pager
Taken.

>socre
That's not a verb I recognise.

>score
You have so far scored 1 out of a possible 10, in 5 turns.

* * *

>take pager
Looks like it will help you along the way.  Keep it if you need hints.

[Your score has just gone up by one point.]

>score
You have so far scored 0 out of a possible 10, in 3 turns.

* * *

>n
Darkness
It's super dark in here!  Well duh, if it's an abandoned building, there is no power.  Maybe you have a source of light already...

>turn flashlight on
Main Arcade Room
 This large room includes the air hockey table and food counter.  In the front, there are many arcade machines, coated with dust, dirt, and spider webs.  The room lights up after being in the dark for so long.  You can picture kids and adults alike spending countless hours engaged in killing aliens, or stacking blocks.  The door to the back alley is behind the hockey table and food counter.  You should probably find the power switch so you don't have to hold your flashlight the whole time.  While old and dusty, it seems as if people have broken in before to walk around and maybe even steal the arcade machines.  The bathroom is to the west, and a party room to the east, according to your boss, and the employees room is to the west of the hockey table. 

You can see Pager, Pac-Man, Space Invaders, Donkey Kong, and Tetris here.

[Your score has just gone up by one point.]

>n
You can't go that way.

>s
Outside
Outside the abonded building, you don't know what to expect.  As long as you have your phone, pen and notepad, you'll be just fine.  Make sure you have some sort of light...

* * *

>n
Darkness
It's super dark in here!  Well duh, if it's an abandoned building, there is no power.  Maybe you have a source of light already...

>turn on flashlight
Now you can see things easier.

Main Arcade Room
 This large room includes the air hockey table and food counter.  In the front, there are many arcade machines, coated with dust, dirt, and spider webs.  The room lights up after being in the dark for so long.  You can picture kids and adults alike spending countless hours engaged in killing aliens, or stacking blocks.  The door to the back alley is behind the hockey table and food counter.  You should probably find the power switch so you don't have to hold your flashlight the whole time.  While old and dusty, it seems as if people have broken in before to walk around and maybe even steal the arcade machines.  The bathroom is to the west, and a party room to the east, according to your boss, and the employees room is to the west of the hockey table. 

You can see Pager, Pac-Man, Space Invaders, Donkey Kong, and Tetris here.

[Your score has just gone up by one point.]

>e
Party Room
This was probably used to hold special party rooms.  There are portable tables set up and a couple boxes in the corner, but other than that, it's a plain room.  Wow, a birthday party in an arcade.  Must've been a 12 year old's dream.

>take paddles
[Your score has just gone up by one point.]

>w
Main Arcade Room
Lots of dusty arcade machines around.  The whole room just gives off a classic, 80s vibe.  Oh boy, what simpler times.

You can see Pager, Pac-Man, Space Invaders, Donkey Kong, and Tetris here.

* * *

>w
Bathroom
For an abandonded building, the bathroom doesn't smell bad and it isn't very dirty.  Strange.

>take puck
Taken.

>e
Main Arcade Room
Lots of dusty arcade machines around.  The whole room just gives off a classic, 80s vibe.  Oh boy, what simpler times.

You can see Pager, Pac-Man, Space Invaders, Donkey Kong, and Tetris here.

>take quarter
[Your score has just gone up by one point.]

>nw
Hockey Table Room
This part of the Main Arcade Room must've been used for hockey table games.  The table is worn down and there are white marks, presumably from the paddles, on the sides.  It must've been very popular.

You can see Air Hockey Table (closed) here.

>unlock table
What do you want to unlock Air Hockey Table with?

>quarter
That's unlocked at the moment.

>se
Main Arcade Room
Lots of dusty arcade machines around.  The whole room just gives off a classic, 80s vibe.  Oh boy, what simpler times.

You can see Pager, Pac-Man, Space Invaders, Donkey Kong, and Tetris here.

>x pager
The brightly lit green screen gives off some light.  Strange to find a working pager in an abonded arcade.  Nevertheless, it seems useful.  Might as well take it.

>talk to pager
That's not a verb I recognise.

>g
That's not a verb I recognise.

>pager
That's not a verb I recognise.

>g
That's not a verb I recognise.

>eat pager
He's plainly inedible.

>x pager
The brightly lit green screen gives off some light.  Strange to find a working pager in an abonded arcade.  Nevertheless, it seems useful.  Might as well take it.

* * *

>w
Main Arcade Room
Lots of dusty arcade machines around.  The whole room just gives off a classic, 80s vibe.  Oh boy, what simpler times.

You can see Pager, Pac-Man, Space Invaders, Donkey Kong, and Tetris here.

>take quarter
[Your score has just gone up by one point.]

* * *

>se
Main Arcade Room
Lots of dusty arcade machines around.  The whole room just gives off a classic, 80s vibe.  Oh boy, what simpler times.

You can see Pager, Pac-Man, Space Invaders, Donkey Kong, and Tetris here.

>w
Bathroom
For an abandonded building, the bathroom doesn't smell bad and it isn't very dirty.  Strange.

* * *

>nw
Hockey Table Room
This part of the Main Arcade Room must've been used for hockey table games.  The table is worn down and there are white marks, presumably from the paddles, on the sides.  It must've been very popular.

You can see Air Hockey Table (closed) here.

>open air hockey table
You can't see any such thing.

>i
You are carrying:
  Air Hockey Puck
  Quarter
  Hockey Paddles
  Pen
  Notepad
  Phone
  Flashlight (providing light)

>unlock air hockey table
You can't see any such thing.

>unlock table1
What do you want to unlock Air Hockey Table with?

>quarter
That's unlocked at the moment.

>paddles
That's not a verb I recognise.

>unlock air hockey table
You can't see any such thing.

>unlock table
What do you want to unlock Air Hockey Table with?

>quarter, paddles, and puck
You can't talk to Quarter.

>unlock table with quarter
That's unlocked at the moment.

>unlock table with paddles
That's unlocked at the moment.

>look
Hockey Table Room
This part of the Main Arcade Room must've been used for hockey table games.  The table is worn down and there are white marks, presumably from the paddles, on the sides.  It must've been very popular.

You can see Air Hockey Table (closed) here.

>unlock table with puck
That's unlocked at the moment.

* * *

>e
Party Room
This was probably used to hold special party rooms.  There are portable tables set up and a couple boxes in the corner, but other than that, it's a plain room.  Wow, a birthday party in an arcade.  Must've been a 12 year old's dream.

>x boxes
A bunch of old, dusty cardboard boxes stacked in the corner.  They seem to make up the shape of a pyramid.  The boxes were placed with such effort and precision, it seems like it would be hiding something.

* * *

>place paddles on air hockey table
You can't see any such thing.

>i
You are carrying:
  Hockey Paddles
  Pen
  Notepad
  Phone
  Flashlight (providing light)

* * *

>look
Darkness
It's super dark in here!  Well duh, if it's an abandoned building, there is no power.  Maybe you should look for a source of light...

>look
Darkness
It's super dark in here!  Well duh, if it's an abandoned building, there is no power.  Maybe you should look for a source of light...

>s
Outside
Outside the abonded building, you don't know what to expect.  As long as you have your phone, pen and notepad, you'll be just fine.  Just go inside and explore!

>n
Darkness
It's super dark in here!  Well duh, if it's an abandoned building, there is no power.  Maybe you should look for a source of light...

* * *

>look
Darkness
It's super dark in here!  Well duh, if it's an abandoned building, there is no power.  Maybe you should look for a source of light...

>x quarter
You can't see any such thing.

>take all
There are none at all available!

* * *

>ne
Food Counter
This part of the Main Arcade Room was probably used to serve all the customers food like pizza, candy, and sodas.  The counter is painted bright red, and there is a bright blue neon sign on the wall saying, "Food and Drink", and a pizza poster.

>take key
Taken.

>nw
Back Alley
A dark and dank back alley.  It seems really dirty and rats sneak in and out past garbage cans.

>unlock electric box
What do you want to unlock Electric Box with?

>key
You unlock Electric Box.

>end game
That's not a verb I recognise.

* * *

>take all
There are none at all available!

>s
Outside
Outside the abonded building, you don't know what to expect.  As long as you have your phone, pen and notepad, you'll be just fine.  Just go inside and explore!

>n
Darkness
It is pitch dark, and you can't see a thing.

* * *

>take pager
I don't suppose Pager would care for that.

>talk to pager
That's not a verb I recognise.

>x pager
The brightly lit green screen gives off some light.  Strange to find a working pager in an abandoned arcade.  Nevertheless, it seems useful.  Might as well take it.

>take quarter
You can possibly use this to play a game.  The air hockey table looks interesting.

[Your score has just gone up by one point.]

>nw
Hockey Table Room
This part of the Main Arcade Room must've been used for hockey table games.  The table is worn down and there are white marks, presumably from the paddles, on the sides.  It must've been very popular.

You can see Air Hockey Table (closed) here.

Pager arrives from the southeast.

>put quarter into hockey table
Air Hockey Table is closed.

>drop quarter
Dropped.

>insert quarter into hockey table
(first taking Quarter)
Air Hockey Table is closed.

* * *

>take quarter
You can possibly use this to play a game.  The air hockey table looks interesting.

[Your score has just gone up by one point.]

* * *

>nw
Hockey Table Room
This part of the Main Arcade Room must've been used for hockey table games.  The table is worn down and there are white marks, presumably from the paddles, on the sides.  It must've been very popular.

You can see Air Hockey Table (closed) here.

Pager arrives from the southeast.

>put quarter in hockey table
Air Hockey Table is closed.

* * *

>turn off flashlight
Flashlight is now off.

>s
Outside
Outside the abonded building, you don't know what to expect.  As long as you have your phone, pen and notepad, you'll be just fine.  Just go inside and explore!

>n
Darkness
It's super dark in here!  Well duh, if it's an abandoned building, there is no power.  Maybe you should find the power...

>take all
There are none at all available!

* * *

>i
You are carrying:
  Pen
  Notepad
  Phone
  Flashlight

>turn on flashlight
Now you can see!

Main Arcade Room
Large aracde with machines.

You can see Pager, Pac-Man, Space Invaders, Donkey Kong, and Tetris here.

>take all
Pager: Looks like it will help you along the way.  You should keep it if you need hints.

[Your score has just gone up by one point.]

* * *

>n
Darkness
It's super dark in here!  Well duh, if it's an abandoned building, there is no power.  Maybe you have a source of light already...

>use flashlight
Now you can see things easier.

Main Arcade Room
 This large room includes the air hockey table and food counter.  But, they are to the northeast, and northwest.  In the front, there are many arcade machines, coated with dust, dirt, and spider webs.  The room lights up after being in the dark for so long.  You can picture kids and adults alike spending countless hours engaged in killing aliens, or stacking blocks.  The back alley is behind the hockey table and food counter.  You should probably find the power switch so you don't have to hold your flashlight the whole time.  While old and dusty, it seems as if people have broken in before to walk around and maybe even steal the arcade machines.  The bathroom is to the west, and a party room to the east, according to your boss, and the employees room is to the west of the hockey table. 

You can see Pager, Pac-Man, Space Invaders, Donkey Kong, and Tetris here.

[Your score has just gone up by one point.]

>e
Party Room
This was probably used to hold special party rooms.  There are portable tables set up and a couple boxes in the corner, but other than that, it's a plain room.  Wow, a birthday party in an arcade.  Must've been a 12 year old's dream.

* * *

>take paddles
You already have that.

>x me
You are curious to see what lies in the abandoned building.  You brought your trusty phone, a pen and paper to jot down any thoughts you have.  As a young, and eager news reporter, this will be your first major scoop.  You can't mess this up!

>i
You are carrying:
  Hockey Paddles
  Pen
  Notepad
  Flashlight (providing light)

* * *

>e
Party Room
This was probably used to hold special party rooms.  There are portable tables set up and a couple boxes in the corner, but other than that, it's a plain room.  Wow, a birthday party in an arcade.  Must've been a 12 year old's dream.

>move boxes to the side
You don't really want to touch them as they are super old and moldy.  They also seem really heavy, which won't allow for

* * *

>e
Party Room
This was probably used to hold special party rooms.  There are portable tables set up and a couple boxes in the corner, but other than that, it's a plain room.  Wow, a birthday party in an arcade.  Must've been a 12 year old's dream.

>open boxes
The boxes are sealed shut.  There doesn't seem to be anything special in the boxes.  But it looks like something might be behind it...

>look behind boxes
You found the two missing paddles for the air hockey table.  Go put it on the table.

* * *

>open boxes
The boxes are sealed shut.  There doesn't seem to be anything special in the boxes.  But it looks like something might be behind it...

>move boxes
It is fixed in place.

* * *

>open boxes
The boxes are sealed shut.  There doesn't seem to be anything special in the boxes.  But it looks like something might be behind it...

>move boxes to the side
You must supply a second noun.

>move the boxes to the side
You must supply a second noun.

* * *

>n
You can't go that way.

>s
Outside
Outside the abandoned building, you don't know what to expect.  As long as you have your phone, pen and notepad, you'll be just fine.  Make sure you have some sort of light...

>n
Darkness
It's super dark in here!  Well duh, if it's an abandoned building, there is no power.  Maybe you have a source of light already...

* * *

>ne
Food Counter
This part of the Main Arcade Room was probably used to serve all the customers food like pizza, candy, and sodas.  The counter is painted bright red, and there is a bright blue neon sign on the wall saying, "Food and Drink", and a pizza poster.

>look behind counter
You found a key!  It might be useful for turning on something...

>take key
You already have that.

>i
You are carrying:
  Key
  Pen
  Notepad
  Flashlight (providing light)
  Phone

* * *

>nw
Hockey Table Room
This part of the Main Arcade Room must've been used for hockey table games.  The table is worn down and there are white marks, presumably from the paddles, on the sides.  It must've been very popular.

You can see Air Hockey Table here.

>x table1
A bright, neon green and blue air hockey table.  It looks like it's still in a playable condition.  If only you had the two paddles and a hockey puck, you could play it.  On the side, there is a sign that says "25 cents required".

* * *

>take pager
[Your score has just gone up by one point.]

>drop paer
You can't see any such thing.

>drop pager
Dropped.

* * *

>take quarter
The pager glows again and says: If you had a birthday party, wouldn't you want to control the air hockey table?

>w
Bathroom
For an abandonded building, the bathroom doesn't smell bad and it isn't very dirty.  Strange.  There's only a sink in here as the toilets were destroyed.

>take paddles
You can't see any such thing.

>take puck
The pager glows once again and says: If you have the paddles and quarter, it's time to play.

>e
Main Arcade Room
Lots of dusty arcade machines around.  The whole room just gives off a classic, 80s vibe.  Oh boy, what simpler times.

You can see Pager, Pac-Man, Space Invaders, Donkey Kong, and Tetris here.

>e
Party Room
This was probably used to hold special party rooms.  There are portable tables set up and a couple boxes in the corner, but other than that, it's a plain room.  Wow, a birthday party in an arcade.  Must've been a 12 year old's dream.

>take paddles
The pager lights up and says: Now you need something to hit.  The puck looks like a bar of soap though...

>w
Main Arcade Room
Lots of dusty arcade machines around.  The whole room just gives off a classic, 80s vibe.  Oh boy, what simpler times.

You can see Pager, Pac-Man, Space Invaders, Donkey Kong, and Tetris here.

>nw
Hockey Table Room
This part of the Main Arcade Room must've been used for hockey table games.  The table is worn down and there are white marks, presumably from the paddles, on the sides.  It must've been very popular.

You can see Air Hockey Table here.

* * *

>x table1
A bright, neon green and blue air hockey table.  It looks like it's still in a playable condition.  If only you had the two paddles and a hockey puck, you could play it.  On the side, there is a sign that says "25 cents required".

>turn on hockey table
It isn't something you can switch.

* * *

>w
Bathroom
For an abandonded building, the bathroom doesn't smell bad and it isn't very dirty.  Strange.  There's only a sink in here as the toilets were destroyed.

>take puck
The pager glows once again and says: If you have the paddles and quarter, it's time to play.

* * *

>x pacman
A classic Pac-Man machine.  Hey, I used to play this at my local arcade!  It's covered in dust from the top to the bottom.  Hey, what's this next to the controls?

>x control
You can't see any such thing.

>x controls
It's used to control Pac-Man.  There is a dusty quarter next to it.

>take quarter
You can possibly use this to play a game.  The air hockey table looks interesting.

[Your score has just gone up by one point.]

>nw
Hockey Table Room
This part of the Main Arcade Room must've been used for hockey table games.  The table is worn down and there are white marks, presumably from the paddles, on the sides.  It must've been very popular.

You can see Air Hockey Table (closed) here.

>x hockey table
A bright, neon green and blue air hockey table.  It looks like it's still in a playable condition.  If only you had the two paddles and a hockey puck, you could play it.  On the side, there is a sign that says "25 cents required".

>x Air hockey table
A bright, neon green and blue air hockey table.  It looks like it's still in a playable condition.  If only you had the two paddles and a hockey puck, you could play it.  On the side, there is a sign that says "25 cents required".

>x hockey
You can't see any such thing.

>se
Main Arcade Room
Lots of dusty arcade machines around.  The whole room just gives off a classic, 80s vibe.  Oh boy, what simpler times.

You can see Pager, Pac-Man, Space Invaders, Donkey Kong, and Tetris here.

>x space
Another classic arcade game.  In fact, I have a Space Invader's alien sticker on my laptop.  The control pad seems to be faded and dusty.  Nothing special seems to stick out.

>x stickey
You can't see any such thing.

>x sticker
You can't see any such thing.

* * *

>n
Darkness
It's super dark in here!  Well duh, if it's an abandoned building, there is no power.  Maybe you have a source of light already...

>use light
Now you can see things easier with the flashlight from your phone.

Main Arcade Room
 This large room includes the air hockey table and food counter.  But, they are to the northeast, and northwest.  In the front, there are many arcade machines, coated with dust, dirt, and spider webs.  The room lights up after being in the dark for so long.  You can picture kids and adults alike spending countless hours engaged in killing aliens, or stacking blocks.  The back alley is behind the hockey table and food counter.  You should probably find the power switch so you don't have to hold your flashlight the whole time.  While old and dusty, it seems as if people have broken in before to walk around and maybe even steal the arcade machines.  The bathroom is to the west, and a party room to the east, according to your boss, and the employees room is to the west of the hockey table. 

You can see Pager, Pac-Man, Space Invaders, Donkey Kong, and Tetris here.

[Your score has just gone up by one point.]

>nw
Hockey Table Room
This part of the Main Arcade Room must've been used for hockey table games.  The table is worn down and there are white marks, presumably from the paddles, on the sides.  It must've been very popular.

You can see Air Hockey Table here.

>se
Main Arcade Room
Lots of dusty arcade machines around.  The whole room just gives off a classic, 80s vibe.  Oh boy, what simpler times.

You can see Pager, Pac-Man, Space Invaders, Donkey Kong, and Tetris here.

>take quarter
The pager glows again and says: If you had a birthday party, wouldn't you want to control the air hockey table?

>nw
Hockey Table Room
This part of the Main Arcade Room must've been used for hockey table games.  The table is worn down and there are white marks, presumably from the paddles, on the sides.  It must've been very popular.

You can see Air Hockey Table here.

>insert quarter into coin slot
Coin Slot is closed.

* * *

>nw
Hockey Table Room
This part of the Main Arcade Room must've been used for hockey table games.  The table is worn down and there are white marks, presumably from the paddles, on the sides.  It must've been very popular.

You can see Air Hockey Table here.

>x table
A bright, neon green and blue air hockey table.  It looks like it's still in a playable condition.  If only you had the two paddles and a hockey puck, you could play it.  You look on the side to see that there is a coin slot that says "25 cents required".

>insert coin
What do you want to insert Coin Slot in?

>coin
(first taking Coin Slot)
You can't put something inside itself.

* * *

>nw
Hockey Table Room
This part of the Main Arcade Room must've been used for hockey table games.  The table is worn down and there are white marks, presumably from the paddles, on the sides.  It must've been very popular.

You can see Air Hockey Table here.

>x tbale
You can't see any such thing.

>x table
A bright, neon green and blue air hockey table.  It looks like it's still in a playable condition.  If only you had the two paddles and a hockey puck, you could play it.  You look on the side to see that there is a coin slot that says "25 cents required".

* * *

>insert coin
What do you want to insert Coin Slot in?

>insert coin into coin slot
(first taking Coin Slot)
You can't put something inside itself.

* * *

>take quarter
The pager glows again and says: If you had a birthday party, wouldn't you want to control the air hockey table?

>e
Party Room
This was probably used to hold special party rooms.  There are portable tables set up and a couple boxes in the corner, but other than that, it's a plain room.  Wow, a birthday party in an arcade.  Must've been a 12 year old's dream.

* * *

>w
Main Arcade Room
Lots of dusty arcade machines around.  The whole room just gives off a classic, 80s vibe.  Oh boy, what simpler times.

You can see Pager, Pac-Man, Space Invaders, Donkey Kong, and Tetris here.

I beg your pardon?

>w
Bathroom
For an abandonded building, the bathroom doesn't smell bad and it isn't very dirty.  Strange.  There's only a sink in here as the toilets were destroyed.

* * *

>e
Main Arcade Room
Lots of dusty arcade machines around.  The whole room just gives off a classic, 80s vibe.  Oh boy, what simpler times.

You can see Pager, Pac-Man, Space Invaders, Donkey Kong, and Tetris here.

>nw
Hockey Table Room
This part of the Main Arcade Room must've been used for hockey table games.  The table is worn down and there are white marks, presumably from the paddles, on the sides.  It must've been very popular.

You can see Air Hockey Table here.

>put paddles on table
You put Hockey Paddles on Air Hockey Table.

>put puck on table
You put Air Hockey Puck on Air Hockey Table.

>insert quarter in coin slot
It makes a clinking sound.

The table seems like it would turn on now, but you remember there is no power supply for the table.  There must be a key that unlocks the Electric Box so you can turn on the power.
The pager lits up and says: The electric box must be outside or in the back alley.  But, you can't open it without a key.  It must be where the employees work...

* * *

>put puck on table
You put Air Hockey Puck on Air Hockey Table.

>put coin in coin slot
(Quarter in Coin Slot)
It makes a clinking sound.

* * *

>w
Main Arcade Room
Lots of dusty arcade machines around.  The whole room just gives off a classic, 80s vibe.  Oh boy, what simpler times.

You can see Pager, Pac-Man, Space Invaders, Donkey Kong, and Tetris here.

>w
Bathroom
For an abandonded building, the bathroom doesn't smell bad and it isn't very dirty.  Strange.  There's only a sink in here as the toilets were destroyed.

* * *

>put puck on table
You put Air Hockey Puck on Air Hockey Table.

>i
You are carrying:
  Quarter
  Pen
  Notepad
  Flashlight (providing light)
  Phone

>insert quarter into coin slot
Coin Slot is closed.

* * *

>put puck on table
You put Air Hockey Puck on Air Hockey Table.

>put coin in coin slt
You can't see any such thing.

>put coin in coin slot
(Quarter in Coin Slot)
It makes a clinking sound.

>i
You are carrying:
  Pen
  Notepad
  Flashlight (providing light)
  Phone

* * *

>take quarter
The pager glows again and says: If you had a birthday party, wouldn't you want to control the air hockey table?

>i
You are carrying:
  Quarter
  Pen
  Notepad
  Flashlight (providing light)
  Phone

* * *

>take quarter
The pager glows again and says: If you had a birthday party, wouldn't you want to control the air hockey table?

>n
You can't go that way.

>e
Party Room
This was probably used to hold special party rooms.  There are portable tables set up and a couple boxes in the corner, but other than that, it's a plain room.  Wow, a birthday party in an arcade.  Must've been a 12 year old's dream.

* * *

>put puck on table
You put Air Hockey Puck on Air Hockey Table.

>insert quarter in coin slot
It makes a clinking sound.

The table seems like it would turn on now, but you remember there is no power supply for the table.  There must be a key that unlocks the Electric Box so you can turn on the power. The pager lits up and says: The electric box must be outside or in the back alley.  But, you can't open it without a key.  It must be where the employees work...

* * *

>nw
Hockey Table Room
This part of the Main Arcade Room must've been used for hockey table games.  The table is worn down and there are white marks, presumably from the paddles, on the sides.  It must've been very popular.

You can see Air Hockey Table here.

>insert coin into coin slot
(Quarter into Coin Slot)
It makes a clinking sound.

>se
Main Arcade Room
Lots of dusty arcade machines around.  The whole room just gives off a classic, 80s vibe.  Oh boy, what simpler times.

You can see Pager, Pac-Man, Space Invaders, Donkey Kong, and Tetris here.

* * *

>put paddles on table
You put Hockey Paddles on Air Hockey Table.

>put puck on table
You put Air Hockey Puck on Air Hockey Table.

You have all the components of the Air Hockey Table.  Now, just find the key that unlocks the Electric Box so you can turn on the power.

* * *

>x me
You are curious to see what lies in the abandoned building.  You brought your trusty phone, a pen and paper to jot down any thoughts you have.  As a young, and eager news reporter, this will be your first major scoop.  You can't mess this up!

>take quarter
The pager glows again and says: If you had a birthday party, wouldn't you want to control the air hockey table?

>x me
You are curious to see what lies in the abandoned building.  You brought your trusty phone, a pen and paper to jot down any thoughts you have.  As a young, and eager news reporter, this will be your first major scoop.  You can't mess this up!

* * *

>x pacman
A classic Pac-Man machine.  Hey, I used to play this at my local arcade!  It's covered in dust from the top to the bottom.  Hey, what's this next to the controls?

>x controls
It's used to control Pac-Man.  There is a dusty quarter next to it.

>take quarter
The pager glows again and says: If you had a birthday party, wouldn't you want to control the air hockey table?

* * *

>nw
Hockey Table Room
This part of the Main Arcade Room must've been used for hockey table games.  The table is worn down and there are white marks, presumably from the paddles, on the sides.  It must've been very popular.

You can see Air Hockey Table here.

>insert coin into coin slot
(Quarter into Coin Slot)
Coin Slot is closed.

* * *

>n
Darkness
It's super dark in here!  Well duh, if it's an abandoned building, there is no power.  Maybe you have a source of light already...

>use phone
It isn't something you can switch.

>turn on phone
It isn't something you can switch.

>throw phoe
You can't see any such thing.

>throw phone
Dropped.

>take phone
You can't see any such thing.

>find phone
That's not a verb I recognise.

>i
You are carrying:
  Pen
  Notepad
  Flashlight

>flashlight
That's not a verb I recognise.

>use flashlight
Now you can see things easier.

Main Arcade Room
 This large room includes the air hockey table and food counter.  In the front, there are many arcade machines, coated with dust, dirt, and spider webs.  The room lights up after being in the dark for so long.  You can picture kids and adults alike spending countless hours engaged in killing aliens, or stacking blocks.  The door to the back alley is behind the hockey table and food counter.  You should probably find the power switch so you don't have to hold your flashlight the whole time.  While old and dusty, it seems as if people have broken in before to walk around and maybe even steal the arcade machines.  The bathroom is to the west, and a party room to the east, according to your boss, and the employees room is to the west of the hockey table. 

You can see Phone, Pager, Pac-Man, Space Invaders, Donkey Kong, and Tetris here.

[Your score has just gone up by one point.]

>take phone
Taken.

>take pager
The pager glows and says: There might be some loose change in the Main Arcade Room.

>take all
There are none at all available!

>take pac-man
That's fixed in place.

>play pac man
That's not a verb I recognise.

>play pac-man
That's not a verb I recognise.

>x pac-man
A classic Pac-Man machine.  Hey, I used to play this at my local arcade!  It's covered in dust from the top to the bottom.  Hey, what's this next to the controls?

>x controls
It's used to control Pac-Man.  There is a dusty quarter next to it.

>x quarter
A normal quarter used to play games.

>take quarter
The pager glows again and says: If you had a birthday party, wouldn't you want to control the air hockey table?

>x hockey table
You can't see any such thing.

>x air hockey table
You can't see any such thing.

* * *

>n
Darkness
It's super dark in here!  Well duh, if it's an abandoned building, there is no power.  Maybe you have a source of light already...

>x me
You are curious to see what lies in the abandoned building.  You brought your trusty phone, a pen and paper to jot down any thoughts you have.  As a young, and eager news reporter, this will be your first major scoop.  You can't mess this up!

>i
You are carrying:
  Pen
  Notepad
  Phone

>x phone
An off brand phone that was assigned to you for stories.  It has standard call and text options, but no app store.  It also comes with a flashlight and bluetooth.

>use flashlight
That's not a verb I recognise.

* * *

>n
Darkness
It's super dark in here!  Well duh, if it's an abandoned building, there is no power.  Maybe you have a source of light already...

>x pac-man machine
A classic Pac-Man Machine.  Hey, I used to play this at my local arcade!  It's covered in dust from the top to the bottom.  Hey, what's this next to the controls?

On Pac-Man Machine is Controls.

>look underneath
You can't see any such thing.

>x pac-man machine
A classic Pac-Man Machine.  Hey, I used to play this at my local arcade!  It's covered in dust from the top to the bottom.  Hey, what's this next to the controls?

On Pac-Man Machine is Controls.

>x joysticks
You can't see any such thing.

>x controls
It's used to control Pac-Man.  There is a dusty quarter next to it.

>take quarter
Taken.

* * *

>n
Darkness
It's super dark in here!  Well duh, if it's an abandoned building, there is no power.  Maybe you have a source of light already...

>x quarter
A normal quarter used to play games.

>take quarter
Taken.

>ne
Food Counter

>sw
Main Arcade Room
You can see Pac-Man Machine here.

>nw
Hockey Table Room
You can see a Hockey Table (closed) here.

>unlock hockey table
What do you want to unlock the Hockey Table with?

>quarter
You unlock the Hockey Table.

* * *

>play phone
There isn't really much to do on your phone.

>play with phone
There isn't really much to do on your phone.

>n
Darkness
It's super dark in here!  Well duh, if it's an abandoned building, there is no power.  Maybe you have a source of light already...

* * *

>play space
You can't play the arcade machines as the power is turned off.  Shucks.

>play kong
You can't play the arcade machines as the power is turned off.  Shucks.

>play tetris
You can't play the arcade machines as the power is turned off.  Shucks.

>x tetris
One of the most recognizable games.  The colors have faded from the blocks on the side of the machine.  It's also covered in dust and spider webs.

>x dust
You can't see any such thing.

>x pac man
A classic Pac-Man machine.  Hey, I used to play this at my local arcade!  It's covered in dust from the top to the bottom.  Hey, what's this next to the controls?

>x kong
Donkey Kong?!  This is where Mario first appeared.  Wow, the colors of the game used to pop off the screen.  Too bad it doesn't work.  Impressive for a game released in 1981.  Nothing special seems to stick out.

>x space
Another classic arcade game.  In fact, I have a Space Invader's alien sticker on my laptop at my office.  Nothing special seems to stick out.

>x tetris
One of the most recognizable games.  The colors have faded from the blocks on the side of the machine.  It's also covered in dust and spider webs.

* * *

>s
You can't go that way.

>n
Darkness
It's super dark in here!  Well duh, if it's an abandoned building, there is no power.  Maybe you have a source of light already...

* * *

>x pac-man
A classic Pac-Man machine.  Hey, I used to play this at my local arcade!  It's covered in dust from the top to the bottom.  Hey, what's this next to the controls?

>take quarter
The pager glows again and says: If you had a birthday party, wouldn't you want to control the air hockey table?

>x air hockey table
You can't see any such thing.

>use quarter
It isn't something you can switch.

>x air hockey table
You can't see any such thing.

>nw
Hockey Table Room
This part of the Main Arcade Room must've been used for hockey table games.  The table is worn down and there are white marks, presumably from the paddles, on the sides.  It must've been very popular.

You can see Air Hockey Table here.

>use coin
You can't see any such thing.

>use quarter
It isn't something you can switch.

>x air hockey table
A bright, neon green and blue air hockey table.  It looks like it's still in a playable condition.  If only you had the two paddles and a hockey puck, you could play it.  On the side, there is a sign that says "25 cents required".

Air Hockey Table is currently switched off.

>switch on
What do you want to switch on?

>air hockey table
You switch Air Hockey Table on.

>play air hockey table
That's not a verb I recognise.

>take paddles
You can't see any such thing.

>take paddle
You can't see any such thing.

>look under air hockey table
You find nothing of interest.

>ne
Back Alley
A dark and dank back alley.  It seems really dirty and rats sneak in and out past garbage cans.

>use flashlight
That's already on.

>x garbage cans
A couple of garbage cans that are no longer in use.  They look pretty disgusting as it hasn't been touched in many, many years.

>se
Food Counter
This part of the Main Arcade Room was probably used to serve all the customers food like pizza, candy, and sodas.  The counter is painted bright red, and there is a bright blue neon sign on the wall saying, "Food and Drink", and a pizza poster.

>x counter
You can't see any such thing.

>x pizza poster
You can't see any such thing.

>take poster
You can't see any such thing.

>take pizza poster
You can't see any such thing.

>sw
Main Arcade Room
Lots of dusty arcade machines around.  The whole room just gives off a classic, 80s vibe.  Oh boy, what simpler times.

You can see Pager, Pac-Man, Space Invaders, Donkey Kong, and Tetris here.

>x space invaders
Another classic arcade game.  In fact, I have a Space Invader's alien sticker on my laptop at my office.  Nothing special seems to stick out.

>x donkey kong
Donkey Kong?!  This is where Mario first appeared.  Wow, the colors of the game used to pop off the screen.  Too bad it doesn't work.  Impressive for a game released in 1981.  Nothing special seems to stick out.

>x tetris
One of the most recognizable games.  The colors have faded from the blocks on the side of the machine.  It's also covered in dust and spider webs.

>x tetris
One of the most recognizable games.  The colors have faded from the blocks on the side of the machine.  It's also covered in dust and spider webs.

>xtetris
That's not a verb I recognise.

>x tetris
One of the most recognizable games.  The colors have faded from the blocks on the side of the machine.  It's also covered in dust and spider webs.

>x Tetris
One of the most recognizable games.  The colors have faded from the blocks on the side of the machine.  It's also covered in dust and spider webs.

>take tetris
That's fixed in place.

>s
Outside
Outside the abandoned building, you don't know what to expect.  As long as you have your phone, pen and notepad, you'll be just fine.  Make sure you have some sort of light...

>n
Main Arcade Room
Lots of dusty arcade machines around.  The whole room just gives off a classic, 80s vibe.  Oh boy, what simpler times.

You can see Pager, Pac-Man, Space Invaders, Donkey Kong, and Tetris here.

* * *

>e
Party Room
This was probably used to hold special party rooms.  There are portable tables set up and a couple boxes in the corner, but other than that, it's a plain room.  Wow, a birthday party in an arcade.  Must've been a 12 year old's dream.

>x box
A bunch of old, dusty cardboard boxes stacked in the corner.  They seem to make up the shape of a pyramid.  The boxes were placed with such effort and precision, it seems like it would be hiding something.

>open box
The boxes are sealed shut.  There doesn't seem to be anything special in the boxes.  But it looks like something might be behind it...

>move box
It is fixed in place.

>look behind box
You found the two missing paddles for the air hockey table.  Go put it on the table.

>take paddles
The pager lights up and says: Now you need something to hit.  The puck looks like a bar of soap though...

* * *

>w
Main Arcade Room
Lots of dusty arcade machines around.  The whole room just gives off a classic, 80s vibe.  Oh boy, what simpler times.

You can see Pager, Pac-Man, Space Invaders, Donkey Kong, and Tetris here.

>e
Party Room
This was probably used to hold special party rooms.  There are portable tables set up and a couple boxes in the corner, but other than that, it's a plain room.  Wow, a birthday party in an arcade.  Must've been a 12 year old's dream.

* * *

>nw
Hockey Table Room
This part of the Main Arcade Room must've been used for hockey table games.  The table is worn down and there are white marks, presumably from the paddles, on the sides.  It must've been very popular.

You can see Air Hockey Table here.

>place paddles on table
Where is the puck?

>summon puck
That's not a verb I recognise.

>se
Main Arcade Room
Lots of dusty arcade machines around.  The whole room just gives off a classic, 80s vibe.  Oh boy, what simpler times.

You can see Pager, Pac-Man, Space Invaders, Donkey Kong, and Tetris here.

>w
Bathroom
For an abandonded building, the bathroom doesn't smell bad and it isn't very dirty.  Strange.  There's only a sink in here as the toilets were destroyed.

>take soap
You can't see any such thing.

>x sink
A normal white sink with dust in the middle.  There seems to be...Oh hey it's the puck.  It looks like a bar of soap.

>take puck
The pager glows once again and says: If you have the paddles and quarter, it's time to play.

* * *

>nw
Hockey Table Room
This part of the Main Arcade Room must've been used for hockey table games.  The table is worn down and there are white marks, presumably from the paddles, on the sides.  It must've been very popular.

You can see Air Hockey Table here.

>play air hockey table
That's not a verb I recognise.

* * *

>i
You are carrying:
  Air Hockey Puck
  Hockey Paddles
  Quarter
  Pen
  Notepad
  Flashlight (providing light)
  Phone

>use quarter
It isn't something you can switch.

>give air hockey table quarter
You can only do that to something animate.

>x notepad
Your trusty notepad that you have used over the past year.  It's riddled with sketches, doodles, and useless notes from stories that didn't make the website.  But, things will change with this story!

>x phone
A standard phone.  There is no real use for calling or texting anyone.

>x pne
You can't see any such thing.

>x pen
A new, ball point pen used for writing down notes.  Don't lose it!

>place paddle on table
You can't see any such thing.

* * *

>x pager
You can't see any such thing.

>x pager
You can't see any such thing.

>i
You are carrying:
  Air Hockey Puck
  Hockey Paddles
  Quarter
  Pen
  Notepad
  Flashlight (providing light)
  Phone

>se
Main Arcade Room
Lots of dusty arcade machines around.  The whole room just gives off a classic, 80s vibe.  Oh boy, what simpler times.

You can see Pager, Pac-Man, Space Invaders, Donkey Kong, and Tetris here.

>take pager
The pager glows and says: There might be some loose change in the Main Arcade Room.

>x pager
The brightly lit green screen gives off some light.  Strange to find a working pager in an abandoned arcade.  Nevertheless, it seems useful.  Might as well take it.

>throw pen
Dropped.

>call phone
That's not a verb I recognise.

>find key
That's not a verb I recognise.

>call key
That's not a verb I recognise.

>listen to pager
You hear nothing unexpected.

>talk to pager
That's not a verb I recognise.

>w
Bathroom
For an abandonded building, the bathroom doesn't smell bad and it isn't very dirty.  Strange.  There's only a sink in here as the toilets were destroyed.

>e
Main Arcade Room
Lots of dusty arcade machines around.  The whole room just gives off a classic, 80s vibe.  Oh boy, what simpler times.

You can see Pen, Pac-Man, Space Invaders, Donkey Kong, and Tetris here.

>e
Party Room
This was probably used to hold special party rooms.  There are portable tables set up and a couple boxes in the corner, but other than that, it's a plain room.  Wow, a birthday party in an arcade.  Must've been a 12 year old's dream.

>w
Main Arcade Room
Lots of dusty arcade machines around.  The whole room just gives off a classic, 80s vibe.  Oh boy, what simpler times.

You can see Pen, Pac-Man, Space Invaders, Donkey Kong, and Tetris here.

>ne
Food Counter
This part of the Main Arcade Room was probably used to serve all the customers food like pizza, candy, and sodas.  The counter is painted bright red, and there is a bright blue neon sign on the wall saying, "Food and Drink", and a pizza poster.

>x sing
You can't see any such thing.

>x sign
You can't see any such thing.

>x counter
You can't see any such thing.

>look behind counter
You can't see any such thing.

>look behind red counter
You can't see any such thing.

>take key
Taken.

* * *

>score
You have so far scored 0 out of a possible 10, in 1 turn.

>n
Main Arcade Room
You can see Pager and Pac-Man Machine (on which is Controls) here.

>take pager
Taken.

>score
You have so far scored 0 out of a possible 10, in 3 turns.

* * *

>take pager
I don't suppose Pager would care for that.

* * *

>turn on flashlight
Now you can see things easier.

[Your score has just gone up by one point.]

>n
Main Arcade Room
 This large room includes the air hockey table and food counter.  In the front, there are many arcade machines, coated with dust, dirt, and spider webs.  The room lights up after being in the dark for so long.  You can picture kids and adults alike spending countless hours engaged in killing aliens, or stacking blocks.  The door to the back alley is behind the hockey table and food counter.  You should probably find the power switch so you don't have to hold your flashlight the whole time.  While old and dusty, it seems as if people have broken in before to walk around and maybe even steal the arcade machines.  The bathroom is to the west, and a party room to the east, according to your boss, and the employees room is to the west of the hockey table. 

You can see Pager, Pac-Man, Space Invaders, Donkey Kong, and Tetris here.

>e
Party Room
This was probably used to hold special party rooms.  There are portable tables set up and a couple boxes in the corner, but other than that, it's a plain room.  Wow, a birthday party in an arcade.  Must've been a 12 year old's dream.

* * *

>nw
Hockey Table Room
This part of the Main Arcade Room must've been used for hockey table games.  The table is worn down and there are white marks, presumably from the paddles, on the sides.  It must've been very popular.

You can see Air Hockey Table here.

>put paddles on hockey table
Putting things on Air Hockey Table would achieve nothing.

>place paddles on top of hockey table
Where is the puck?

>se
Main Arcade Room
Lots of dusty arcade machines around.  The whole room just gives off a classic, 80s vibe.  Oh boy, what simpler times.

You can see Pager, Pac-Man, Space Invaders, Donkey Kong, and Tetris here.

* * *

>w
Bathroom
For an abandonded building, the bathroom doesn't smell bad and it isn't very dirty.  Strange.

>take puck
The pager glows once again and says: If you have the paddles and quarter, it's time to play.

* * *

>e
Main Arcade Room
Lots of dusty arcade machines around.  The whole room just gives off a classic, 80s vibe.  Oh boy, what simpler times.

You can see Pager, Pac-Man, Space Invaders, Donkey Kong, and Tetris here.

>take quarter
The pager glows again and says: If you had a birthday party, wouldn't you want to control the air hockey table?

* * *

>nw
Hockey Table Room
This part of the Main Arcade Room must've been used for hockey table games.  The table is worn down and there are white marks, presumably from the paddles, on the sides.  It must've been very popular.

You can see Air Hockey Table here.

>insert quarter into hockey table
That can't contain things.

* * *

>turn flashlight off
Flashlight is now off.

It is now pitch dark in here!

>s
Outside
Outside the abonded building, you don't know what to expect.  As long as you have your phone, pen and notepad, you'll be just fine.  Just go inside and explore!

* * *

>n
Darkness
It is pitch dark, and you can't see a thing.

>turn on flashlight
Now you can see!

Main Arcade Room
Large aracde with machines.

You can see Pager, Pac-Man, Space Invaders, Donkey Kong, and Tetris here.

* * *

>turn on flashlight
That's already on.

>look
Darkness
It's super dark in here!  Well duh, if it's an abandoned building, there is no power.  Maybe you should look for a source of light...

* * *

>use flashlight
That's not a verb I recognise.

>ne
Food Counter
This part of the Main Arcade Room was probably used to serve all the customers food like pizza, candy, and sodas.  The counter is painted bright red, and there is a bright blue neon sign on the wall saying, "Food and Drink", and a pizza poster.

>sw
Darkness
It's super dark in here!  Well duh, if it's an abandoned building, there is no power.  Maybe you should look for a source of light...

>nw
Hockey Table Room
This part of the Main Arcade Room must've been used for hockey table games.  The table is worn down and there are white marks, presumably from the paddles, on the sides.  It must've been very popular.

You can see Air Hockey Table (closed) here.

* * *

>x pac man
A classic Pac-Man machine.  Hey, I used to play this at my local arcade!  It's covered in dust from the top to the bottom.  Hey, what's this next to the controls?

>x pacman
A classic Pac-Man machine.  Hey, I used to play this at my local arcade!  It's covered in dust from the top to the bottom.  Hey, what's this next to the controls?

>x space
Another classic arcade game.  In fact, I have a Space Invader's alien sticker on my laptop.  The control pad seems to be faded and dusty.  Nothing special seems to stick out.

>x invaders
Another classic arcade game.  In fact, I have a Space Invader's alien sticker on my laptop.  The control pad seems to be faded and dusty.  Nothing special seems to stick out.

>x pac-man
A classic Pac-Man machine.  Hey, I used to play this at my local arcade!  It's covered in dust from the top to the bottom.  Hey, what's this next to the controls?

* * *

>turn on light
Now you can see things easier with the flashlight from your phone.

[Your score has just gone up by one point.]

>n
Main Arcade Room
 This large room includes the air hockey table and food counter.  But, they are to the northeast, and northwest.  In the front, there are many arcade machines, coated with dust, dirt, and spider webs.  The room lights up after being in the dark for so long.  You can picture kids and adults alike spending countless hours engaged in killing aliens, or stacking blocks.  The back alley is behind the hockey table and food counter.  You should probably find the power switch so you don't have to hold your flashlight the whole time.  While old and dusty, it seems as if people have broken in before to walk around and maybe even steal the arcade machines.  The bathroom is to the west, and a party room to the east, according to your boss, and the employees room is to the west of the hockey table. 

You can see Pager, Pac-Man, Space Invaders, Donkey Kong, and Tetris here.

>x me
You are curious to see what lies in the abandoned building.  You brought your trusty phone, a pen and paper to jot down any thoughts you have.  As a young, and eager news reporter, this will be your first major scoop.  You can't mess this up!

>x pacman
A classic Pac-Man machine.  Hey, I used to play this at my local arcade!  It's covered in dust from the top to the bottom.  Hey, what's this next to the controls?

* * *

>u
You can't go that way.

>use light
Now you can see things easier with the flashlight from your phone.

[Your score has just gone up by one point.]

>n
Main Arcade Room
 This large room includes the air hockey table and food counter.  But, they are to the northeast, and northwest.  In the front, there are many arcade machines, coated with dust, dirt, and spider webs.  The room lights up after being in the dark for so long.  You can picture kids and adults alike spending countless hours engaged in killing aliens, or stacking blocks.  The back alley is behind the hockey table and food counter.  You should probably find the power switch so you don't have to hold your flashlight the whole time.  While old and dusty, it seems as if people have broken in before to walk around and maybe even steal the arcade machines.  The bathroom is to the west, and a party room to the east, according to your boss, and the employees room is to the west of the hockey table. 

You can see Pager, Pac-Man, Space Invaders, Donkey Kong, and Tetris here.

>nw
Hockey Table Room
This part of the Main Arcade Room must've been used for hockey table games.  The table is worn down and there are white marks, presumably from the paddles, on the sides.  It must've been very popular.

You can see Air Hockey Table here.

>x coin slot
The coin slot for the air hockey table. Insert one quarter in coin slot to play air hockey. Only a quarter? What a deal!

>put quarter in coin slot
You can't see any such thing.

* * *

>use
What do you want to use?

>pen
You are already taking notes.

>use phone
There is nothing useful to use your phone.

* * *

>use flash
You can't see any such thing.

>use light
You can't see any such thing.

* * *

>use flashlight
Now you can see things easier with the flashlight from your phone.

[Your score has just gone up by one point.]

>l
Outside
Outside the abandoned building, you don't know what to expect.  As long as you have your phone, pen and notepad, you'll be just fine.  Make sure you have some sort of light...

>n
Main Arcade Room
 This large room includes the air hockey table and food counter.  In the front, there are many arcade machines, coated with dust, dirt, and spider webs.  The room lights up after being in the dark for so long.  You can picture kids and adults alike spending countless hours engaged in killing aliens, or stacking blocks.  The door to the back alley is behind the hockey table and food counter.  You should probably find the power switch so you don't have to hold your flashlight the whole time.  While old and dusty, it seems as if people have broken in before to walk around and maybe even steal the arcade machines.  The bathroom is to the west, and a party room to the east, according to your boss, and the employees room is to the west of the hockey table. 

You can see Pager, Pac-Man, Space Invaders, Donkey Kong, and Tetris here.

>take Pager
The pager glows and says: There might be some loose change in the Main Arcade Room.

>i
You are carrying:
  Pager
  Pen
  Notepad
  Flashlight (providing light)

* * *

>use flashlight
Now you can see things easier with the flashlight from your phone.

[Your score has just gone up by one point.]

>n
Main Arcade Room
 This large room includes the air hockey table and food counter.  But, they are to the northeast, and northwest.  In the front, there are many arcade machines, coated with dust, dirt, and spider webs.  The room lights up after being in the dark for so long.  You can picture kids and adults alike spending countless hours engaged in killing aliens, or stacking blocks.  The back alley is behind the hockey table and food counter.  You should probably find the power switch so you don't have to hold your flashlight the whole time.  While old and dusty, it seems as if people have broken in before to walk around and maybe even steal the arcade machines.  The bathroom is to the west, and a party room to the east, according to your boss, and the employees room is to the west of the hockey table. 

You can see Pager, Pac-Man, Space Invaders, Donkey Kong, and Tetris here.

>e
Party Room
This was probably used to hold special party rooms.  There are portable tables set up and a couple boxes in the corner, but other than that, it's a plain room.  Wow, a birthday party in an arcade.  Must've been a 12 year old's dream.

* * *

>nw
Hockey Table Room
This part of the Main Arcade Room must've been used for hockey table games.  The table is worn down and there are white marks, presumably from the paddles, on the sides.  It must've been very popular.

You can see Air Hockey Table (closed) here.

>w
You can't go that way.

>se
Main Arcade Room
Lots of dusty arcade machines around.  The whole room just gives off a classic, 80s vibe.  Oh boy, what simpler times.

You can see Pager, Pac-Man, Space Invaders, Donkey Kong, and Tetris here.

* * *

>w
Main Arcade Room
Lots of dusty arcade machines around.  The whole room just gives off a classic, 80s vibe.  Oh boy, what simpler times.

You can see Pager, Pac-Man, Space Invaders, Donkey Kong, and Tetris here.

>s
Outside
Outside the abonded building, you don't know what to expect.  As long as you have your phone, pen and notepad, you'll be just fine.  Make sure you have some sort of light...

* * *

>n
Main Arcade Room
Lots of dusty arcade machines around.  The whole room just gives off a classic, 80s vibe.  Oh boy, what simpler times.

You can see Pager, Pac-Man, Space Invaders, Donkey Kong, and Tetris here.

>nw
Hockey Table Room
This part of the Main Arcade Room must've been used for hockey table games.  The table is worn down and there are white marks, presumably from the paddles, on the sides.  It must've been very popular.

You can see Air Hockey Table (closed) here.

>ne
Back Alley
A dark and dank back alley.  It seems really dirty and rats sneak in and out past garbage cans and cardboard boxes.

>sw
Hockey Table Room
This part of the Main Arcade Room must've been used for hockey table games.  The table is worn down and there are white marks, presumably from the paddles, on the sides.  It must've been very popular.

You can see Air Hockey Table (closed) here.

* * *

>w
Main Arcade Room
Lots of dusty arcade machines around.  The whole room just gives off a classic, 80s vibe.  Oh boy, what simpler times.

You can see Pager, Pac-Man, Space Invaders, Donkey Kong, and Tetris here.

>take quarter
The pager glows again and says: If you had a birthday party, wouldn't you want to control the air hockey table?

* * *

>take puck
The pager glows once again and says: If you have the paddles and quarter, it's time to play.

>n
You can't go that way.

>e
Main Arcade Room
Lots of dusty arcade machines around.  The whole room just gives off a classic, 80s vibe.  Oh boy, what simpler times.

You can see Pager, Pac-Man, Space Invaders, Donkey Kong, and Tetris here.

* * *

>nw
Hockey Table Room
This part of the Main Arcade Room must've been used for hockey table games.  The table is worn down and there are white marks, presumably from the paddles, on the sides.  It must've been very popular.

You can see Air Hockey Table here.

>switch air hockey table on
You have all the components of the Air Hockey Table.  Now, just find the key that unlocks the Electric Box so you can turn on the power.

* * *

>ne
Food Counter
This part of the Main Arcade Room was probably used to serve all the customers food like pizza, candy, and sodas.  The counter is painted bright red, and there is a bright blue neon sign on the wall saying, "Food and Drink", and a pizza poster.

* * *

>nw
Hockey Table Room
This part of the Main Arcade Room must've been used for hockey table games.  The table is worn down and there are white marks, presumably from the paddles, on the sides.  It must've been very popular.

You can see Air Hockey Table here.

>x hockey table
A bright, neon green and blue air hockey table.  It looks like it's still in a playable condition.  If only you had the two paddles and a hockey puck, you could play it.  On the side, there is a sign that says "25 cents required".

* * *

>nw
Hockey Table Room
This part of the Main Arcade Room must've been used for hockey table games.  The table is worn down and there are white marks, presumably from the paddles, on the sides.  It must've been very popular.

You can see Air Hockey Table here.

>x table1
A bright, neon green and blue air hockey table.  It looks like it's still in a playable condition.  If only you had the two paddles and a hockey puck, you could play it.  On the side, there is a sign that says "25 cents required".

Air Hockey Table is currently switched off.

>switch table1 on
You switch Air Hockey Table on.

* * *

>take pager
The pager glows and says: There might be some loose change in the Main Arcade Room.

>take quarter
The pager glows again and says: If you had a birthday party, wouldn't you want to control the air hockey table?

* * *

>take paddles
The pager lights up and says: Now you need something to hit.  The puck looks like a bar of soap though...

>ww
That's not a verb I recognise.

>w
Main Arcade Room
Lots of dusty arcade machines around.  The whole room just gives off a classic, 80s vibe.  Oh boy, what simpler times.

You can see Pac-Man, Space Invaders, Donkey Kong, and Tetris here.

>w
Bathroom
For an abandonded building, the bathroom doesn't smell bad and it isn't very dirty.  Strange.

* * *

>take puck
The pager glows once again and says: If you have the paddles and quarter, it's time to play.

>e
Main Arcade Room
Lots of dusty arcade machines around.  The whole room just gives off a classic, 80s vibe.  Oh boy, what simpler times.

You can see Pac-Man, Space Invaders, Donkey Kong, and Tetris here.

>ne
Food Counter
This part of the Main Arcade Room was probably used to serve all the customers food like pizza, candy, and sodas.  The counter is painted bright red, and there is a bright blue neon sign on the wall saying, "Food and Drink", and a pizza poster.

* * *

>nw
Back Alley
A dark and dank back alley.  It seems really dirty and rats sneak in and out past garbage cans.

>unlock electric box with key
You unlock Electric Box.

>open electric box
You open Electric Box.

* * *

>take pager
The pager glows and says: There might be some loose change in the Main Arcade Room.

>x pac man
A classic Pac-Man machine.  Hey, I used to play this at my local arcade!  It's covered in dust from the top to the bottom.  Hey, what's this next to the controls?

>take quarter
The pager glows again and says: If you had a birthday party, wouldn't you want to control the air hockey table?

* * *

>x boxes
A bunch of old, dusty cardboard boxes stacked in the corner.  They seem to make up the shape of a pyramid.  The boxes were placed with such effort and precision, it seems like it would be hiding something.

>take paddles
The pager lights up and says: Now you need something to hit.  The puck looks like a bar of soap though...

>w
Main Arcade Room
Lots of dusty arcade machines around.  The whole room just gives off a classic, 80s vibe.  Oh boy, what simpler times.

You can see Pac-Man, Space Invaders, Donkey Kong, and Tetris here.

>w
Bathroom
For an abandonded building, the bathroom doesn't smell bad and it isn't very dirty.  Strange.  There's only a sink in here as the toilets were destroyed.

>w
You can't go that way.

>take puck
The pager glows once again and says: If you have the paddles and quarter, it's time to play.

* * *

>e
Main Arcade Room
Lots of dusty arcade machines around.  The whole room just gives off a classic, 80s vibe.  Oh boy, what simpler times.

You can see Pac-Man, Space Invaders, Donkey Kong, and Tetris here.

>nw
Hockey Table Room
This part of the Main Arcade Room must've been used for hockey table games.  The table is worn down and there are white marks, presumably from the paddles, on the sides.  It must've been very popular.

You can see Air Hockey Table here.

* * *

>x pager
The brightly lit green screen gives off some light.  Strange to find a working pager in an abandoned arcade.  Nevertheless, it seems useful.  Might as well take it.

>take quarter
[Your score has just gone up by one point.]

* * *

>take quarter
The pager glows again and says: If you had a birthday party, wouldn't you want to control the air hockey table?

* * *

>e
Main Arcade Room
Lots of dusty arcade machines around.  The whole room just gives off a classic, 80s vibe.  Oh boy, what simpler times.

You can see Pager, Pac-Man, Space Invaders, Donkey Kong, and Tetris here.

>ne
Food Counter
This part of the Main Arcade Room was probably used to serve all the customers food like pizza, candy, and sodas.  The counter is painted bright red, and there is a bright blue neon sign on the wall saying, "Food and Drink", and a pizza poster.

* * *

>nw
Back Alley
A dark and dank back alley.  It seems really dirty and rats sneak in and out past garbage cans.

>unlock electric box with key
The power turned on!  After that, everything else came to life and it was like you were a child again, spending a weekend grinding the machines.  Eventually, you quit your job as a reporter and aquired the arcade.  You run one of the most popular arcades in the city now.  Business is booming!

    *** The End ***

In that game you scored 1 out of a possible 6, in 13 turns.

Would you like to RESTART, RESTORE a saved game, QUIT, or UNDO the last command?

* * *

>use light
Now you can see things easier with the flashlight from your phone.

[Your score has just gone up by one point.]

* * *

>play pac-man
You can't play the arcade machines as the power is turned off.  Shucks.

* * *

>ww
That's not a verb I recognise.

>w
Main Arcade Room
Lots of dusty arcade machines around.  The whole room just gives off a classic, 80s vibe.  Oh boy, what simpler times.

You can see Pager, Pac-Man, Space Invaders, Donkey Kong, and Tetris here.

* * *

>nw
Hockey Table Room
This part of the Main Arcade Room must've been used for hockey table games.  The table is worn down and there are white marks, presumably from the paddles, on the sides.  It must've been very popular.

You can see Air Hockey Table here.

>put paddles on top of table1
You can't see any such thing.

>put paddles on hockey table
You put Hockey Paddles on Air Hockey Table.

>put puck on hockey table
You put Air Hockey Puck on Air Hockey Table.

>insert quarter into coin slot
Coin Slot is closed.

* * *

>take quarter
The pager glows again and says: If you had a birthday party, wouldn't you want to control the air hockey table?

>take pager
The pager glows and says: There might be some loose change in the Main Arcade Room.

>e
Party Room
This was probably used to hold special party rooms.  There are portable tables set up and a couple boxes in the corner, but other than that, it's a plain room.  Wow, a birthday party in an arcade.  Must've been a 12 year old's dream.

* * *

>insert coin into coin slot
(Quarter into Coin Slot)
Coin Slot is closed.

>put paddles on table
You put Hockey Paddles on Air Hockey Table.

* * *

>put puck on table
You put Air Hockey Puck on Air Hockey Table.

>put quarter in coin slot
Coin Slot is closed.

* * *

>x me
You are curious to see what lies in the abandoned building.  You brought your trusty phone, a pen and paper to jot down any thoughts you have.  As a young, and eager news reporter, this will be your first major scoop.  You can't mess this up!

>e
Party Room
This was probably used to hold special party rooms.  There are portable tables set up and a couple boxes in the corner, but other than that, it's a plain room.  Wow, a birthday party in an arcade.  Must've been a 12 year old's dream.

* * *

>nw
Hockey Table Room
This part of the Main Arcade Room must've been used for hockey table games.  The table is worn down and there are white marks, presumably from the paddles, on the sides.  It must've been very popular.

You can see Air Hockey Table here.

>switch hockey table on
It isn't something you can switch.

>turn table1 on
It isn't something you can switch.

>switch table1 on
It isn't something you can switch.

* * *

>x pacman
A classic Pac-Man machine.  Hey, I used to play this at my local arcade!  It's covered in dust from the top to the bottom.  Hey, what's this next to the controls?

>x dust
A buildup of many different small particles.  Pretty much expected in an abandoned building.

>take pager
The pager glows and says: There might be some loose change in the Main Arcade Room.

* * *

>use phone
There is not much to do with your phone.

>use notepad
You are taking notes.

>write on notepad
That's not a verb I recognise.

>x notepad
Your trusty notepad that you have used over the past year.  It's riddled with sketches, doodles, and useless notes from stories that didn't make the website.  But, things will change with this story!

* * *

>x e
You see nothing unexpected in that direction.

>x me
You are curious to see what lies in the abandoned building.  You brought your trusty phone, a pen and paper to jot down any thoughts you have.  As a young, and eager news reporter, this will be your first major scoop.  You can't mess this up!

>n
Darkness
It's super dark in here!  Well duh, if it's an abandoned building, there is no power.  Maybe you have a source of light already...

* * *

>nw
Hockey Table Room
This part of the Main Arcade Room must've been used for hockey table games.  The table is worn down and there are white marks, presumably from the paddles, on the sides.  It must've been very popular.

You can see Air Hockey Table here.

>x table1
A bright, neon green and blue air hockey table.  It looks like it's still in a playable condition.  If only you had the two paddles and a hockey puck, you could play it.  You look on the side to see that there is a coin slot that says "25 cents required".

>insert coin
What do you want to insert Coin Slot in?

>insert coin in coin slot
(first taking Coin Slot)
That's fixed in place.

* * *

>x me
You are curious to see what lies in the abandoned building.  You brought your trusty phone, a pen and paper to jot down any thoughts you have.  As a young, and eager news reporter, this will be your first major scoop.  You can't mess this up!

>i
You are carrying:
  Pen
  Notepad
  Phone
  Flashlight

* * *

>use flashlight
That's not a verb I recognise.

>look
Outside
Outside the abonded building, you don't know what to expect.  As long as you have your phone, pen and notepad, you'll be just fine.  Just go inside

>n
Main Arcade Room
You can see Pager, Pac-Man, Space Invaders, Donkey Kong, and Tetris here.

>nw
Hockey Table Room
You can see a Hockey Table (closed) here.

>x hockey talb
I only understood you as far as wanting to examine the Hockey Table.

>x hockey table
A bright, neon green and blue air hockey table.  It looks like it's still in a playable condition.  If only you had the two paddles and a hockey puck, you could play it.  On the side, there is a sign that says "25 cents required".

>ne
Back Alley

>sw
Hockey Table Room
You can see a Hockey Table (closed) here.

>se
Main Arcade Room
You can see Pager, Pac-Man, Space Invaders, Donkey Kong, and Tetris here.

>e
Party Room

>e
You can't go that way.

>w
Main Arcade Room
You can see Pager, Pac-Man, Space Invaders, Donkey Kong, and Tetris here.

>w
Bathroom

>w
You can't go that way.

>s
You can't go that way.

>e
Main Arcade Room
You can see Pager, Pac-Man, Space Invaders, Donkey Kong, and Tetris here.

>s
Outside
Outside the abonded building, you don't know what to expect.  As long as you have your phone, pen and notepad, you'll be just fine.  Just go inside

* * *

>n
Darkness
It's super dark in here!  Well duh, if it's an abandoned building, there is no power.  Maybe you have a source of light already...

>nw
Hockey Table

* * *

>n
Darkness
It's super dark in here!  Well duh, if it's an abandoned building, there is no power.  Maybe you have a source of light already...

>use flashlight
Now you can see things easier with the flashlight from your phone.

Main Arcade Room
 This large room includes the air hockey table and food counter.  But, they are to the northeast, and northwest.  In the front, there are many arcade machines, coated with dust, dirt, and spider webs.  The room lights up after being in the dark for so long.  You can picture kids and adults alike spending countless hours engaged in killing aliens, or stacking blocks.  The back alley is behind the hockey table and food counter.  You should probably find the power switch so you don't have to hold your flashlight the whole time.  While old and dusty, it seems as if people have broken in before to walk around and maybe even steal the arcade machines.  The bathroom is to the west, and a party room to the east, according to your boss, and the employees room is to the west of the hockey table. 

You can see Pager, Pac-Man, Space Invaders, Donkey Kong, and Tetris here.

[Your score has just gone up by one point.]

>take quarter
The pager glows again and says: If you had a birthday party, wouldn't you want to control the air hockey table?

>x me
You can feel the excitement on your face as things are starting to get interesting.

* * *

>x me
You are curious to see what lies in the abandoned building.  You brought your trusty phone, a pen and paper to jot down any thoughts you have.  As a young, and eager news reporter, this will be your first major scoop.  You can't mess this up!

>use light
Now you can see things easier with the flashlight from your phone.

[Your score has just gone up by one point.]

* * *

>x me
You are curious to see what lies in the abandoned building.  You brought your trusty phone, a pen and paper to jot down any thoughts you have.  As a young, and eager news reporter, this will be your first major scoop.  You can't mess this up!

>w
Bathroom
For an abandonded building, the bathroom doesn't smell bad and it isn't very dirty.  Strange.  There's only a sink in here as the toilets were destroyed.

>e
Main Arcade Room
Lots of dusty arcade machines around.  The whole room just gives off a classic, 80s vibe.  Oh boy, what simpler times.

You can see Pager, Pac-Man, Space Invaders, Donkey Kong, and Tetris here.

* * *

>nw
Hockey Table Room
This part of the Main Arcade Room must've been used for hockey table games.  The table is worn down and there are white marks, presumably from the paddles, on the sides.  It must've been very popular.

You can see Air Hockey Table here.

>ne
Back Alley
A dark and dank back alley.  It seems really dirty and rats sneak in and out past garbage cans.

>se
Food Counter
This part of the Main Arcade Room was probably used to serve all the customers food like pizza, candy, and sodas.  The counter is painted bright red, and there is a bright blue neon sign on the wall saying, "Food and Drink", and a pizza poster.

* * *

>sw
Main Arcade Room
Lots of dusty arcade machines around.  The whole room just gives off a classic, 80s vibe.  Oh boy, what simpler times.

You can see Pager, Pac-Man, Space Invaders, Donkey Kong, and Tetris here.

>ne
Food Counter
This part of the Main Arcade Room was probably used to serve all the customers food like pizza, candy, and sodas.  The counter is painted bright red, and there is a bright blue neon sign on the wall saying, "Food and Drink", and a pizza poster.

>sw
Main Arcade Room
Lots of dusty arcade machines around.  The whole room just gives off a classic, 80s vibe.  Oh boy, what simpler times.

You can see Pager, Pac-Man, Space Invaders, Donkey Kong, and Tetris here.

>w
Bathroom
For an abandonded building, the bathroom doesn't smell bad and it isn't very dirty.  Strange.  There's only a sink in here as the toilets were destroyed.

* * *

>take key
You already have that.

>nw
Back Alley
A dark and dank back alley.  It seems really dirty and rats sneak in and out past garbage cans.

* * *

>unlock electric box with key
You unlock Electric Box.

>turn on power
You can't see any such thing.

* * *

>x me
You are curious to see what lies in the abandoned building.  You brought your trusty phone, a pen and paper to jot down any thoughts you have.  As a young, and eager news reporter, this will be your first major scoop.  You can't mess this up!

>x outside
You see nothing unexpected in that direction.

>look
Outside
Outside the abonded building, you don't know what to expect.  As long as you have your phone, pen and notepad, you'll be just fine.  Just go inside and explore!

>n
Darkness
It's super dark in here!  Well duh, if it's an abandoned building, there is no power.  Maybe you should look for a source of light...

>turn of flashlight
You can't see any such thing.

>turn on flashlight
[Your score has just gone up by one point.]

* * *

>x phone
A standard phone.  There is no real use for calling or texting anyone.

>i
You are carrying:
  Pen
  Notepad
  Flashlight
  Phone

>x me
You are curious to see what lies in the abandoned building.  You brought your trusty phone, a pen and paper to jot down any thoughts you have.  As a young, and eager news reporter, this will be your first major scoop.  You can't mess this up!