As you walk up to the old, abandoned building on Elk Street, a chill runs down your spine.

Retro Arcade
An Interactive Fiction by Aaron Murai
Release 1 / Serial number 170213 / Inform 7 build 6M62 (I6/v6.33 lib 6/12N) SD

Outside

>i
You are carrying:
  Pencil
  Notepad

>eat pencil
That's plainly inedible.

* * *

As you walk up to the old, abandoned building on Elk Street, a chill runs down your spine.

Retro Arcade
An Interactive Fiction by Aaron Murai
Release 1 / Serial number 170213 / Inform 7 build 6M62 (I6/v6.33 lib 6/12N) SD

Outside

>n
Main Arcade Room

* * *

As you walk up to the old, abandoned building on Elk Street, a chill runs down your spine.

Retro Arcade
An Interactive Fiction by Aaron Murai
Release 1 / Serial number 170213 / Inform 7 build 6M62 (I6/v6.33 lib 6/12N) SD

Outside

>x me
You are curious to see what lies in the abandoned building.  You brought your trusty camera, a pencil and paper to jot down any thoughts you have.  As a young, and eager news reporter, this will be your first major scoop.  You can't mess this up!

>n
Main Arcade Room